10 / 10 = 1
20 / 10 = 2
30 / 10 = 3
40 / 10 = 4
50 / 10 = 5
60 / 10 = 6
70 / 10 = 7
80 / 10 = 8
90 / 10 = 9
11 / 11 = 1
22 / 11 = 2
33 / 11 = 3
44 / 11 = 4
55 / 11 = 5
66 / 11 = 6
77 / 11 = 7
88 / 11 = 8
99 / 11 = 9
12 / 12 = 1
24 / 12 = 2
36 / 12 = 3
48 / 12 = 4
60 / 12 = 5
72 / 12 = 6
84 / 12 = 7
96 / 12 = 8
