10 / 2 = 5
12 / 2 = 6
14 / 2 = 7
16 / 2 = 8
18 / 2 = 9
20 / 2 = 10
22 / 2 = 11
24 / 2 = 12
12 / 3 = 4
15 / 3 = 5
18 / 3 = 6
21 / 3 = 7
24 / 3 = 8
27 / 3 = 9
30 / 3 = 10
33 / 3 = 11
36 / 3 = 12
10 / 5 = 2
15 / 5 = 3
20 / 5 = 4
25 / 5 = 5
30 / 5 = 6
35 / 5 = 7
40 / 5 = 8
45 / 5 = 9
50 / 5 = 10
55 / 5 = 11
60 / 5 = 12
12 / 6 = 2
18 / 6 = 3
24 / 6 = 4
30 / 6 = 5
36 / 6 = 6
42 / 6 = 7
48 / 6 = 8
54 / 6 = 9
60 / 6 = 10
66 / 6 = 11
72 / 6 = 12
14 / 7 = 2
21 / 7 = 3
28 / 7 = 4
35 / 7 = 5
42 / 7 = 6
49 / 7 = 7
56 / 7 = 8
63 / 7 = 9
70 / 7 = 10
77 / 7 = 11
84 / 7 = 12
16 / 8 = 2
24 / 8 = 3
32 / 8 = 4
40 / 8 = 5
48 / 8 = 6
56 / 8 = 7
64 / 8 = 8
72 / 8 = 9
80 / 8 = 10
88 / 8 = 11
96 / 8 = 12
18 / 9 = 2
27 / 9 = 3
36 / 9 = 4
45 / 9 = 5
54 / 9 = 6
63 / 9 = 7
72 / 9 = 8
81 / 9 = 9
90 / 9 = 10
99 / 9 = 11
